4-4-4-4-0-0-0-0-4-4-4-4-0-0-0-0-4-4-4-4-0-0-0-0-4-4-4-4-0-0-0-0-4-4-4-4-0-0-0-0
4-1-1-4-0-0-0-0-4-1-1-4-0-0-0-0-4-1-1-4-0-0-0-0-4-1-1-4-0-0-0-0-4-1-1-4-0-0-0-0
4-1-1-4-0-0-0-0-4-1-1-4-0-0-0-0-4-1-1-4-0-0-0-0-4-1-1-4-0-0-0-0-4-1-1-4-0-0-0-0
4-1-1-4-0-0-0-0-4-1-1-4-0-0-0-0-4-1-1-4-0-0-0-0-4-1-1-4-0-0-0-0-4-1-1-4-0-0-0-0
4-1-1-4-4-4-4-4-4-1-1-4-4-4-4-4-4-1-1-4-4-4-4-4-4-1-1-4-4-5-4-4-4-1-1-4-4-4-4-4
4-1-1-1-1-1-1-1-1-1-1-1-1-1-1-1-1-1-1-1-1-1-1-1-1-1-1-1-1-1-1-1-1-1-1-1-1-1-1-4
4-1-1-1-1-1-1-1-1-1-1-1-1-1-1-1-1-1-1-1-1-1-3-3-3-1-1-1-1-1-1-1-1-1-1-1-1-1-1-4
4-1-1-1-1-1-1-1-1-1-1-1-1-1-1-1-1-1-1-1-1-1-1-1-2-1-1-1-1-1-1-1-1-1-1-1-1-1-1-4
4-1-1-1-1-1-1-1-1-1-1-1-1-1-1-1-1-1-1-1-1-1-1-1-3-1-1-1-1-1-1-1-1-1-1-2-1-1-1-4
4-1-1-1-1-2-1-1-1-1-1-1-1-1-2-1-1-1-1-1-1-1-1-1-3-1-1-1-1-1-1-1-1-1-1-2-2-3-3-4
4-1-1-1-1-2-1-1-1-1-1-1-1-1-2-1-1-1-1-1-1-1-1-1-2-1-1-1-1-1-1-1-1-1-1-2-1-1-1-4
4-1-1-1-1-2-1-1-1-1-1-1-1-1-2-1-1-1-1-1-1-1-1-1-2-1-1-1-1-1-1-1-1-1-1-1-1-1-1-4
4-1-1-1-1-2-1-1-1-1-1-1-1-1-2-1-1-1-1-1-1-1-1-1-2-1-1-1-1-1-1-1-1-1-1-1-1-1-1-4
4-1-3-1-1-2-1-1-2-3-3-1-1-1-2-1-1-1-1-1-1-1-1-1-2-1-1-1-1-1-1-1-1-1-1-1-1-1-1-4
4-1-1-1-1-2-1-1-1-1-1-1-1-1-2-1-1-1-1-1-1-1-1-1-1-1-1-1-1-1-1-1-1-1-1-1-1-1-1-4
4-1-1-1-1-2-1-1-1-1-1-1-1-1-2-1-1-1-1-1-1-1-1-1-2-3-3-3-2-2-1-1-1-1-1-1-1-1-1-4
4-1-1-1-1-2-1-1-1-1-1-1-1-1-2-1-1-1-1-1-1-1-1-1-1-1-1-1-1-1-1-1-1-1-1-1-1-1-1-4
4-1-1-1-1-3-3-3-3-3-3-3-3-3-3-1-1-1-1-1-1-1-1-1-1-1-1-1-1-1-1-1-1-1-1-1-1-1-1-4
4-1-1-1-1-1-1-1-1-1-1-1-1-1-1-1-1-1-1-1-1-1-1-1-1-1-1-1-1-1-1-1-1-1-1-1-1-1-1-4
4-4-4-4-4-4-4-4-4-4-4-4-4-4-4-4-4-4-4-4-4-4-4-4-4-4-4-4-4-4-4-4-4-4-4-4-4-4-4-4